date;us_and_canada;europe;asia_pacific;rest_of_world;total_advertising_revenue
2018-12-31;8246;4087;2742;1565;16640
2019-03-31;7203;3609;2670;1430;14912
2019-06-30;7952;4043;2985;1644;16624
2019-09-30;8317;4057;3243;1766;17383
2019-12-31;10021;5071;3642;2002;20736
2020-03-31;8379;4171;3236;1654;17440
2020-06-30;9059;4411;3312;1539;18321
2020-09-30;9988;5051;4202;1980;21221
2020-12-31;13150;6822;4703;2512;27187
2021-03-31;11897;6373;4735;2434;25439
2021-06-30;13366;7205;5152;2857;28580
2021-09-30;13094;6821;5398;2963;28276
2021-12-31;15062;8174;6183;3220;32639
2022-03-31;12024;6364;5661;2949;26998
2022-06-30;12788;6360;5835;3169;28152
2022-09-30;12766;5707;5717;3047;27237
2022-12-31;15005;6904;5968;3377;31254
2023-03-31;12710;6269;5893;3229;28101
